Aeroporto Internacional de São Paulo - Guarulhos - Governador André Franco Montoro
Aeroporto de São Paulo/Congonhas - Deputado Freitas Nobre
Aeroporto do Rio de Janeiro - Santos Dumont
Aeroporto Internacional de Curitiba - Afonso Pena
Aeroporto internacional de Brasília
Aeroporto de Campina Grande - Presidente João Suassuna
Aeroporto Internacional Tom Jobim - Rio Galeão
Aeroporto Internacional do Recife/Guararapes - Gilberto Freyre
Aeroporto Internacional de Porto Alegre - Salgado Filho
Aeroporto Internacional de Fortaleza - Pinto Martins
Aeroporto Internacional de Salvador - Dep. Luís Eduardo Magalhães
Aeroporto de Vitória - Eurico de Aguiar Salles
Aeroporto Internacional de Confins
Aeroporto de Londrina - Governador José Richa
Aeroporto Internacional de Belém - Val-de-Cans - Júlio Cezar Ribeiro
Aeroporto Internacional de Manaus - Eduardo Gomes
Aeroporto Internacional de Florianópolis - Hercílio Luz
Aeroporto Internacional de Foz do Iguaçu/Cataratas
Aeroporto Internacional de Navegantes - Ministro Victor Konder
Aeroporto Internacional de Campo Grande
Aeroporto Internacional Cuiabá/Várzea Grande – Marechal Rondon MT
Aeroporto de Goiânia - Santa Genoveva
Aeroporto Internacional de Maceió - Zumbi dos Palmares
Aeroporto Internacional de João Pessoa - Presidente Castro Pinto
Aeroporto Internacional de São Luís - Marechal Cunha Machado
Aeroporto de Uberlândia - Ten. Cel. Aviador César Bombonato
Aeroporto de Joinville - Lauro Carneiro de Loyola
Aeroporto Internacional Santa Maria - Aracaju
Aeroporto de Teresina - Senador Petrônio Portella
Aeroporto Internacional de Natal
Aeroporto Internacional de Porto Velho - Gov. Jorge Teixeira de Oliveira
Aeroporto de Palmas - Brigadeiro Lysias Rodrigues
Aeroporto de Belo Horizonte - Pampulha - Carlos Drummond de Andrade
Aeroporto de Petrolina - Senador Nilo Coelho
Aeroporto de Juazeiro do Norte - Orlando Bezerra de Menezes
Aeroporto de Rio Branco - Plácido de Castro
Aeroporto Internacional de Macapá - Alberto Alcolumbre
Aeroporto Internacional de Boa Vista - Atlas Brasil Cantanhede
Aeroporto de Santarém - Maestro Wilson Fonseca
Aeroporto de Imperatriz - Prefeito Renato Moreira
Aeroporto de Tefé
Aeroporto Internacional de São José dos Campos - Professor Urbano Ernesto Stumpf
Aeroporto de Marabá - João Correa da Rocha
Aeroporto de Carajás
Aeroporto de Macaé
Aeroporto de Jacarepaguá - Roberto Marinho
Aeroporto de Uberaba - Mário de Almeida Franco
Aeroporto Internacional de Pelotas/RS - João Simões Lopes Neto
Aeroporto de Montes Claros - Mário Ribeiro
Aeroporto de Altamira - Pará
Aeroporto de São Paulo - Campo de Marte
Aeroporto do Paraná - Bacacheri
Aeroporto de Belo Horizonte - Carlos Prates
Aeroporto de Belém - Brigadeiro Protásio de Oliveira
Aeroporto Internacional Cruzeiro do Sul
Aeroporto Internacional de Parnaíba - Prefeito Dr. João Silva Filho
Aeroporto Internacional de Viracopos - Campinas
Aeroporto de Paulo Afonso
Aeroporto Internacional de Tabatinga
Aeroporto Internacional de Uruguaiana - Rubem Berta
Aeroporto Internacional de Corumbá
Aeroporto Internacional de Bagé - Comandante Gustavo Kraemer
Aeroporto Internacional de Ponta Porã